+--------+
|@  A |  |
|@    |  |
|   --+B |
|  @     |
|     @  |
|  C     |
|@  @ @  |
+--------+