+--------+
|   A |  |
|@    |  |
|   --+B |
|  @     |
|     @  |
|  C     |
|   @ @  |
+--------+