+----------------------------+
|                            |
|        A                   |
|             @              |
|       |                    |
|       |           @        |
|       |                    |
|-------+        B           |
|                            |
|  @      |   C              |
|    @    |                  |
|--------+                   |
|                            |
|                            |
|                            |
|                    @       |
|   @                        |
|                            |
|                            |
|                            |
|                            |
|                            |
|                            |
|                            |
|                            |
|                     @      |
|                            |
|                            |
|                            |
+----------------------------+