+--------+
|   A    |
|@       |
|     B  |
|  @     |
|     @  |
|  C     |
|   @ @  |
+--------+